15 15
0 0 14 14
R R R R R R R R R R R R R R R
R G G G R R R R R R R R R R R
R G S S R X X R R R R R R R R
R G S S R X X R R R R R R R R
R R R R R R R R R R R R R R R
R R R R R R R R R R R R R R R
R R R R R R R R R R R R R R R
R R R R R R R R R R R R R R R
R R R R R R R R R R R R R R R
R R R R R R R R R R R R R R R
R R R R R R R R R R R R R R R
R R R R R R R R R R R R R R R
R R R R R R R R R R R R R R R
R R R R R R R R R R R R R R R
R R R R R R R R R R R R R R R
