10 10
0 0 9 9
R R R R R R R R R R
R G G G R R R R R R
R G S S R X X R R R
R G S S R X X R R R
R R R R R R R R R R
R R R R R R R R R R
R R R R R R R R R R
R R R R R R R R R R
R R R R R R R R R R
R R R R R R R R R R