5 5
0 0 4 4
R R R R R
R G G R R
R X X R R
R R R R R
R R R R R